XXXXXXXXXXXXXXXXXXXX
X  S     X         X
X  S     X         X
X  SSS   X         X
X  S S   X  SSSSS  X
X  SSS   X    S    X
X        X    S    X
X        X    S    X
X        X         X
X        X         X
XXXXXXXXXWXXXXXXXXXX
X        X         X
X  SSS   X  SSSSS  X
X  S  S  X     S   X
X  S  S  X    S    X
X  S  S  X    S    X
X  SSS   X    S    X
X        X         X
X        X         X
XXXXXXXXXXXXXXXXXXXX