 XXXXXXXXXXXXXXXXXX
X        X         X
X        X         X
X        X  SSS    X
X        X  S S    X
X        X  S S    X
X        X SSSSS   X
X        X S S S   X
X        X SSSSS   X
X        X         X
XXXXXXXXXWXXXXXXXXXX
X        X         X
X        X         X
X        X         X
X        X         X
X        X         X
X        X         X
X        X         X
X        X         X
 XXXXXXXXXXXXXXXXXX 
